3 0 0 0 0 0 0 0 0 0 0 0 0 0 0 0 0 0 0 0 0 0 0 0 0 0 0 0 0 0 0 0 0 0 0 0 0 0 0 0 
3 0 0 0 0 0 0 0 0 0 0 0 0 0 0 0 0 0 0 0 0 0 0 0 0 0 0 0 0 0 12 0 0 0 0 0 0 0 0 0 
3 0 0 0 0 0 0 0 50 0 0 0 0 0 0 0 0 0 0 0 0 0 0 0 0 0 0 0 0 0 36 0 0 0 0 0 8 0 0 0 
3 0 0 0 0 0 50 0 38 26 0 0 0 0 0 0 0 0 0 40 0 0 0 0 0 0 0 0 12 0 36 0 0 0 0 0 0 0 0 0 
3 0 0 0 0 0 0 38 30 30 0 0 0 0 33 26 19 0 0 0 0 0 0 0 0 0 0 0 36 0 36 0 33 19 0 0 0 0 12 0 
3 0 0 0 0 0 38 30 30 30 0 51 0 0 0 0 0 0 0 0 0 0 0 0 0 0 12 0 36 0 36 0 0 0 0 0 0 0 30 0 
3 0 0 0 0 38 30 30 30 30 0 0 0 0 52 0 0 0 0 12 0 0 0 0 0 0 36 0 36 0 36 0 0 0 0 0 0 0 30 0 
30 26 26 26 26 45 30 30 30 30 26 26 26 26 26 26 26 26 26 30 0 38 26 26 26 26 36 26 36 26 36 26 26 26 26 26 26 26 30 26 
30 30 30 30 30 30 30 30 30 30 30 30 30 30 30 30 30 30 30 30 26 30 30 30 30 30 30 30 30 30 30 30 30 30 30 30 30 30 30 30 
15 15 15 15 15 15 15 15 15 15 15 15 15 15 15 15 15 15 15 15 15 15 15 15 15 15 15 15 15 15 15 15 15 15 15 15 15 15 15 15